1	1	1	1	1	1	1	1	1	1	1	1	1	1	1	1	1	1	1	1	1	1	1	1	1	1	1	2	1	1	1	1	1	1	1	1	1	1	1	1	1	1	1	1	1	1	1	1	1	1	1	1	1	1	3	1	1	1	1	1	1	1	1	1	1	1	1	1	1	1	1	1	1	1	1	1	1	1	1	1	1	1	1	1	1	1	1	1	1	1	1	1	1	1	1	1	1	1	1	1	1	1	1	1	1	1	1	1	4	1	1	1	1	1	1	1	1	1	1	1	1	1	1	1	1	1	1	1	1	5	5	5	5	5	5	1	1	1	1	6	7	7	7	7	7	7	7	7	7	7	7	7	7	7	7	7	7	7	7	1	1	1	1	1
1	1	1	1	1	1	1	1	1	1	1	1	1	1	1	1	1	1	1	1	1	1	3	1	1	1	1	1	1	1	1	1	1	1	1	1	1	1	1	1	1	1	1	1	1	1	1	1	1	1	1	1	1	1	1	1	1	1	1	1	1	1	1	1	1	1	1	1	1	1	1	1	1	1	1	1	1	1	1	1	1	1	1	1	1	1	1	1	1	1	1	1	1	1	1	1	1	1	1	1	4	1	1	1	1	1	1	1	1	1	1	1	1	1	1	1	1	1	1	1	1	1	1	1	1	1	1	1	1	1	1	8	9	1	1	1	1	1	1	6	7	7	7	7	7	7	7	7	7	7	7	7	7	7	7	7	7	7	7	1	1	1	1	1
1	1	1	2	1	1	1	1	1	1	1	1	4	2	1	1	1	1	1	1	1	1	1	1	1	1	1	1	1	1	1	1	4	1	1	1	1	1	1	1	1	1	1	1	1	1	1	1	1	1	1	1	1	1	1	1	1	1	1	2	1	1	1	1	1	1	1	1	1	1	1	1	1	1	1	1	1	1	1	1	1	1	1	1	1	1	1	1	1	1	1	1	1	1	1	1	1	2	1	1	1	1	1	1	1	1	1	1	1	1	1	1	1	1	1	1	1	1	1	1	1	1	1	1	1	1	1	1	1	1	1	8	9	1	1	1	1	1	1	6	7	7	7	7	7	7	7	7	7	7	7	7	7	7	7	7	7	7	7	1	1	1	1	1
1	1	1	1	1	1	1	1	1	1	1	1	1	1	1	1	1	1	1	1	1	1	1	1	1	1	1	1	1	1	1	1	1	1	1	1	1	1	1	1	1	1	1	1	1	1	3	1	1	1	3	1	1	2	1	1	1	1	1	1	1	1	1	1	1	1	1	1	1	1	1	1	1	1	1	1	1	1	1	1	1	1	1	1	1	1	1	1	1	2	1	1	1	1	3	1	1	1	1	1	1	1	1	2	1	1	1	1	1	1	1	1	1	1	1	1	1	1	1	1	1	1	1	1	1	1	1	1	4	1	1	8	9	1	1	1	1	1	1	6	7	7	7	7	7	7	7	7	7	7	7	7	7	7	7	7	7	7	7	1	1	1	1	1
1	1	1	1	1	1	3	1	1	1	1	1	1	1	1	1	1	1	1	1	1	1	1	1	1	1	1	1	1	1	1	1	1	1	1	1	1	1	1	1	1	1	1	1	1	1	1	1	1	1	1	1	1	1	1	1	1	1	1	1	1	1	1	1	1	1	1	1	1	1	1	1	1	1	1	1	1	1	1	1	1	1	1	1	1	1	1	1	1	1	1	1	1	1	1	1	1	1	1	1	1	1	1	1	1	1	1	1	1	1	1	1	1	1	1	1	1	1	1	1	1	1	1	2	1	1	1	1	1	1	1	8	9	1	3	1	1	1	1	6	7	7	7	7	7	7	7	7	7	7	7	7	7	7	7	7	7	7	7	1	1	1	1	1
1	1	1	1	1	1	1	1	1	1	1	1	1	1	1	1	1	1	1	1	1	1	1	1	1	1	1	1	1	1	1	1	1	1	1	1	1	1	1	1	1	1	1	1	1	1	1	1	1	1	1	1	1	1	1	1	1	1	1	1	1	1	1	1	1	1	1	1	1	1	1	1	1	1	1	1	1	1	1	1	1	1	1	1	1	1	1	1	1	1	1	1	1	1	1	1	1	1	1	1	1	1	1	1	1	1	1	1	1	1	1	1	1	1	1	1	1	1	1	1	1	1	1	1	1	1	1	1	1	1	1	10	11	1	1	1	1	1	1	6	7	7	7	7	7	7	7	7	7	7	7	7	7	7	7	7	7	7	7	1	1	1	1	1
1	1	1	1	1	1	1	1	1	1	1	1	1	1	1	1	1	1	1	1	1	1	1	1	1	2	3	1	1	1	1	1	1	1	1	1	1	1	1	1	1	1	1	1	4	1	1	1	1	1	1	1	1	1	1	1	1	1	1	1	1	1	1	1	4	1	1	1	1	1	1	1	1	1	1	1	1	1	1	1	1	1	1	1	1	1	1	1	1	1	1	1	1	2	1	1	1	1	1	1	1	1	1	1	1	1	1	1	4	1	1	1	1	1	1	1	1	1	3	1	1	1	1	1	1	1	1	1	1	1	1	1	1	1	1	1	1	1	1	6	7	7	7	7	7	7	7	7	7	7	7	7	7	7	7	7	7	7	7	1	1	1	1	1
1	1	1	1	1	1	1	1	1	1	1	1	1	1	1	1	1	1	1	1	1	1	1	1	1	1	1	1	1	1	1	1	1	1	1	1	1	1	1	1	1	1	1	1	1	1	1	1	1	1	1	1	1	1	1	1	1	1	1	1	1	1	1	1	1	1	1	1	1	1	1	1	1	1	1	1	1	1	1	1	1	1	1	1	1	1	1	1	1	1	1	1	1	1	1	1	1	2	1	1	1	1	1	1	1	1	1	1	1	1	1	1	1	1	1	1	1	1	1	1	1	1	1	1	1	1	1	1	1	1	1	1	1	1	1	1	1	1	1	6	7	7	7	7	7	7	7	7	7	7	7	7	7	7	7	7	7	7	7	1	1	1	1	1
1	1	1	1	1	1	1	1	1	1	1	1	1	2	1	1	1	1	1	1	1	1	1	1	1	1	1	1	1	1	1	1	1	1	1	1	1	1	1	1	1	1	1	1	1	1	1	1	1	1	1	1	1	1	1	1	1	1	1	1	1	1	1	1	1	1	1	1	1	1	1	1	1	1	1	1	1	1	1	1	1	1	1	1	1	1	1	1	1	1	1	1	1	1	1	1	1	1	1	1	1	2	1	1	1	1	1	2	1	1	1	1	1	1	1	1	1	1	1	1	1	1	1	1	1	1	1	1	1	1	1	1	1	1	1	1	1	1	1	6	7	7	7	7	7	7	7	7	7	7	7	7	7	7	7	7	7	7	7	1	1	1	1	1
1	2	1	1	1	1	1	1	1	1	1	1	1	1	1	1	1	1	1	1	1	1	1	1	1	1	1	1	1	1	1	1	1	1	1	1	1	1	1	1	1	1	1	1	1	1	1	1	1	1	1	1	1	1	1	1	1	1	1	1	1	1	1	1	1	1	1	1	1	1	1	1	1	1	1	1	1	1	1	1	1	1	1	1	1	1	1	1	1	1	1	1	1	1	1	1	1	1	1	1	1	1	1	1	1	1	1	1	1	1	1	1	1	1	1	1	1	2	1	1	1	1	1	1	1	1	1	1	1	1	1	1	1	1	1	1	1	1	1	6	7	7	7	7	7	7	7	7	7	7	7	7	7	7	7	7	7	7	7	1	1	1	1	1
1	1	1	1	1	1	1	1	1	1	1	1	1	1	1	1	1	1	1	1	1	1	1	1	1	1	1	1	1	1	1	1	1	1	1	1	1	1	1	1	1	1	1	1	1	1	1	1	1	1	1	1	1	1	1	1	1	1	1	1	1	1	1	1	1	1	1	1	1	1	1	1	1	1	1	1	1	1	1	1	1	1	1	1	1	1	1	1	1	1	1	1	1	1	1	1	1	1	1	1	1	1	1	1	1	1	1	1	1	1	1	1	1	1	1	1	1	1	1	1	1	1	1	1	1	1	1	1	1	1	1	1	1	1	1	1	1	1	1	6	7	7	7	7	7	7	7	7	7	7	7	7	7	7	7	7	7	7	7	1	1	1	1	1
1	1	1	1	1	1	1	1	1	1	1	1	1	1	1	1	1	1	1	1	1	1	1	1	1	1	1	1	1	1	1	1	1	1	1	1	1	1	1	1	1	1	1	1	1	1	1	1	1	1	1	1	1	1	1	1	1	1	1	1	1	1	1	1	1	1	1	1	1	1	1	1	1	1	1	1	1	1	1	1	1	1	1	1	1	1	1	1	1	1	1	1	1	1	1	1	1	1	1	1	1	1	1	1	1	1	1	1	1	1	1	1	1	1	1	1	1	1	1	1	1	1	1	1	1	1	1	1	1	1	1	1	1	1	1	1	1	1	1	6	7	7	7	7	7	7	7	7	7	7	7	7	7	7	7	7	7	7	7	1	1	1	1	1
1	1	1	1	1	1	1	1	1	1	1	1	1	1	1	1	1	1	1	1	1	1	1	1	1	1	1	1	1	1	1	1	1	1	1	1	1	1	1	1	1	1	1	1	1	1	1	1	1	1	1	1	1	1	1	1	1	1	1	1	1	1	1	1	1	1	1	1	1	1	1	1	1	1	1	1	1	1	1	1	1	1	1	1	1	1	1	1	1	1	1	1	1	1	1	1	1	1	1	1	1	1	1	1	1	1	1	1	1	1	1	1	1	1	1	1	1	1	1	1	1	1	1	1	1	1	1	1	1	1	1	1	1	1	1	1	1	1	1	6	7	7	7	7	7	7	7	7	7	7	7	7	7	7	7	7	7	7	7	1	1	1	1	1
1	1	1	1	1	1	1	1	1	1	1	1	1	1	1	1	1	1	1	1	1	1	1	1	1	1	1	1	1	1	1	1	1	1	1	1	1	1	1	1	1	1	1	1	1	1	1	1	1	1	1	1	1	1	1	1	1	1	1	1	1	1	1	1	1	1	1	1	1	1	1	1	1	1	1	1	1	1	1	1	1	1	1	1	1	1	1	1	1	1	1	1	1	1	1	1	1	1	1	1	1	1	1	1	1	1	1	1	1	1	1	1	1	1	1	1	1	1	1	1	1	1	1	1	1	1	1	1	1	1	1	1	1	1	1	1	1	1	1	6	7	7	7	7	7	7	7	7	7	7	7	7	7	7	7	7	7	7	7	1	1	1	1	1
1	1	1	1	1	1	1	1	1	1	1	1	1	1	1	1	1	1	1	1	1	1	1	1	1	1	1	1	1	1	1	1	1	1	1	1	1	1	1	1	1	1	1	1	1	1	1	1	1	1	1	1	1	1	1	1	1	1	1	1	1	1	1	1	1	1	1	1	1	1	1	1	1	1	1	1	1	1	1	1	1	1	1	1	1	1	1	1	1	1	1	1	1	1	1	1	1	1	1	1	1	1	1	1	1	1	1	1	1	1	1	1	1	1	1	1	1	1	1	1	1	1	1	1	1	1	1	1	1	1	1	1	1	1	1	1	1	1	1	6	7	7	7	7	7	7	7	7	7	7	7	7	7	7	7	7	7	7	7	1	1	1	1	1
1	1	1	1	1	1	1	1	1	1	1	1	1	1	1	1	1	1	1	1	1	1	1	1	1	1	1	1	1	1	1	1	1	1	1	1	1	1	1	1	1	1	1	1	1	1	1	1	1	1	1	1	1	1	1	1	1	1	1	1	1	1	1	1	1	1	1	1	1	1	1	1	1	1	1	1	1	1	1	1	1	1	1	1	1	1	1	1	1	1	1	1	1	1	1	1	1	1	1	1	1	1	1	1	1	1	1	1	1	1	1	1	1	1	1	1	1	1	1	1	1	1	1	1	1	1	1	1	1	1	1	1	1	1	1	1	1	1	1	6	7	7	7	7	7	7	7	7	7	7	7	7	7	7	7	7	7	7	7	1	1	1	1	1
1	1	1	1	1	1	1	1	1	1	1	1	1	1	1	1	1	1	1	1	1	1	1	1	1	1	1	12	13	14	1	1	1	1	1	1	1	1	1	1	1	1	1	1	1	1	1	1	1	1	1	1	1	1	1	1	1	1	1	1	1	1	1	1	1	1	1	1	1	1	1	1	1	1	1	1	1	1	1	1	1	1	1	1	1	1	1	1	1	1	1	1	1	1	1	1	1	1	1	1	1	1	1	1	1	1	1	1	1	1	1	1	1	1	1	1	1	1	1	1	1	1	1	1	1	1	1	1	1	1	1	1	1	1	1	1	1	1	1	6	7	7	7	7	7	7	7	7	7	7	7	7	7	7	7	7	7	7	7	1	1	1	1	1
1	1	1	1	1	1	1	1	1	1	1	1	1	1	1	1	1	1	1	1	1	1	1	1	1	1	1	15	16	17	1	1	1	1	1	1	1	1	1	1	1	1	1	1	1	1	1	1	1	1	1	1	12	13	14	1	1	1	1	1	1	1	1	1	1	1	1	12	13	13	13	14	1	1	1	1	1	1	1	1	1	1	1	1	1	1	1	1	1	1	1	1	1	1	1	1	1	1	18	19	19	20	21	1	1	1	1	1	1	1	1	1	1	1	1	1	1	1	1	1	1	1	1	1	1	1	1	1	1	1	1	1	1	1	1	1	1	1	1	6	7	7	7	7	7	7	7	7	7	7	7	7	7	7	7	7	7	7	7	1	1	1	1	1
1	1	1	1	1	1	1	1	1	1	1	1	1	1	1	1	1	1	1	1	1	1	1	22	23	1	1	1	1	1	1	1	1	1	1	1	1	1	1	1	1	1	1	22	23	1	1	1	1	1	1	1	15	16	17	1	1	1	1	1	1	1	1	1	1	1	1	15	16	16	16	17	1	1	1	1	1	1	1	1	1	1	1	1	1	1	1	22	23	1	1	1	1	1	1	1	1	1	24	25	25	26	27	1	1	1	1	1	1	1	1	1	1	1	1	1	1	1	1	1	1	28	29	29	30	21	1	1	1	1	1	1	1	22	23	1	1	1	1	6	7	7	7	7	7	7	7	7	7	7	7	7	7	7	7	7	7	7	7	1	1	1	1	1
1	1	1	1	1	1	1	1	1	1	1	1	1	1	1	1	1	1	1	1	1	1	1	31	32	23	1	1	1	1	1	1	1	1	1	1	1	1	1	1	1	1	1	31	32	23	1	1	1	1	1	1	1	1	1	1	1	1	1	1	1	1	1	1	1	1	1	1	1	1	1	1	1	1	1	1	1	1	1	1	1	1	1	1	1	1	1	31	32	23	1	12	13	13	14	1	1	1	33	34	34	34	35	1	1	1	1	1	28	29	29	30	21	1	1	1	1	1	1	1	1	36	37	37	38	27	1	1	1	1	1	1	1	31	32	23	1	1	1	6	7	7	7	7	7	7	7	7	7	7	7	7	7	7	7	7	7	7	7	1	1	1	1	1
1	1	1	1	1	1	1	12	13	13	14	1	1	1	1	1	1	1	1	1	1	1	1	31	39	40	1	1	1	1	1	1	1	1	1	1	1	1	1	1	1	1	1	31	39	40	1	1	1	1	1	1	1	1	1	1	12	13	13	14	1	1	1	1	1	1	1	1	1	1	1	1	1	1	1	1	1	1	1	1	1	1	1	1	1	1	1	31	39	40	1	15	16	16	17	1	1	1	1	1	1	1	1	1	1	1	1	1	41	42	42	43	27	1	1	1	44	45	45	46	21	36	37	37	38	27	1	1	1	1	1	1	1	31	39	40	1	1	1	6	7	7	7	7	7	7	47	48	7	7	7	49	50	51	7	7	7	7	7	1	1	1	1	1
1	1	1	1	1	1	1	15	16	16	17	1	1	1	28	29	29	30	21	1	1	1	22	52	39	40	1	1	1	1	1	1	1	1	1	1	1	1	1	1	1	1	22	52	39	40	1	1	1	1	1	1	1	1	1	1	15	16	16	17	1	1	1	1	1	1	1	1	1	1	1	1	1	1	1	1	1	1	1	1	1	1	1	1	1	1	22	52	39	40	1	1	1	1	1	1	1	1	1	1	1	1	1	55	56	56	57	21	33	34	34	34	35	1	1	1	58	59	59	60	27	36	37	37	38	27	1	1	1	1	1	1	22	52	39	40	1	1	1	6	7	7	7	7	7	7	61	62	7	7	7	63	7	64	7	7	7	7	7	1	1	1	1	1
1	1	1	1	1	1	1	1	1	1	1	1	1	1	41	42	42	43	27	1	1	22	52	39	39	40	1	1	1	1	1	1	1	1	1	1	1	1	1	1	1	22	52	39	39	1	1	1	1	1	1	1	1	1	1	1	1	1	1	1	1	1	1	1	1	1	1	1	1	1	1	22	23	1	1	1	1	1	1	1	1	1	1	1	1	22	52	39	39	40	1	1	1	1	1	1	1	1	1	1	1	1	1	66	67	67	68	27	1	1	18	19	19	19	20	21	33	34	34	34	35	36	37	37	38	27	1	1	1	1	1	22	52	39	39	40	1	1	1	6	7	7	7	7	7	7	61	47	48	7	7	69	70	71	7	7	7	7	7	1	1	1	1	1
1	1	1	1	1	1	1	1	1	1	1	1	1	1	33	34	34	34	35	1	1	31	39	39	39	40	1	1	1	1	1	1	1	1	1	1	1	1	1	1	1	31	39	39	39	40	1	1	1	1	1	1	1	1	1	22	23	1	1	1	1	1	1	1	1	1	1	1	1	1	22	52	40	22	23	1	1	23	1	1	1	1	1	1	1	31	39	39	39	40	1	1	1	1	1	1	1	44	45	45	45	46	21	33	34	34	34	35	1	1	24	25	25	25	26	27	1	1	1	1	1	36	37	37	38	27	1	1	1	22	23	31	39	39	39	40	1	1	1	6	7	7	7	7	7	7	61	7	62	7	7	7	7	7	7	7	7	47	48	1	1	1	1	1
1	1	1	1	1	1	1	1	1	1	1	44	45	45	46	21	1	1	1	1	1	31	39	39	39	32	23	1	1	1	1	1	1	1	1	1	1	1	1	1	1	31	39	39	39	32	23	1	1	1	1	1	1	1	1	31	32	23	1	1	1	1	1	1	1	1	1	1	1	1	31	32	52	39	40	1	1	32	23	1	1	1	1	1	1	31	39	39	39	32	23	1	1	1	1	1	1	58	59	59	59	60	27	1	1	1	1	1	1	1	33	34	34	34	34	35	1	1	1	1	1	36	37	37	38	27	1	1	1	31	32	52	39	39	39	32	23	1	1	6	7	7	7	7	7	7	61	7	47	48	7	7	7	7	7	7	7	61	62	1	1	1	1	1
1	1	1	1	73	73	73	73	1	1	1	58	59	59	60	27	1	1	1	1	1	31	39	39	39	39	40	1	1	73	73	1	1	1	1	1	1	1	1	1	1	31	39	39	39	39	40	1	1	1	1	1	1	1	22	52	39	40	73	1	1	1	1	1	73	73	73	1	1	1	31	39	39	39	40	22	1	39	40	1	1	1	1	1	1	31	39	39	39	39	40	1	1	1	1	1	1	33	34	34	34	34	35	73	73	73	73	73	73	1	1	1	1	1	1	1	73	73	1	1	1	41	42	42	43	27	1	1	22	52	39	39	39	39	39	39	40	1	1	6	7	7	7	7	7	47	48	7	7	62	7	7	7	7	7	7	47	48	62	1	1	1	1	1
74	75	75	75	75	75	75	75	75	75	75	75	75	75	75	75	75	75	75	75	75	75	75	75	75	75	75	75	75	75	75	75	75	75	75	75	75	75	75	75	75	75	75	75	75	75	75	75	75	75	75	75	75	75	75	75	75	75	75	75	75	75	75	75	75	75	75	75	75	75	75	75	75	75	75	75	75	75	75	76	1	74	75	75	75	75	75	75	75	75	75	76	1	74	75	75	75	75	75	75	75	75	75	75	75	75	75	75	75	75	75	75	75	75	75	75	75	75	75	75	75	75	75	75	75	75	75	75	75	75	75	75	75	75	75	75	75	75	75	75	75	75	75	75	75	75	75	75	75	75	75	75	75	75	75	75	75	75	75	1	1	1	1	1
1	1	1	1	1	1	1	1	1	1	1	1	1	1	1	1	1	1	1	1	1	1	1	1	1	1	1	1	1	1	1	1	1	1	1	1	1	1	1	1	1	1	1	1	1	1	1	1	1	1	1	1	1	1	1	1	1	1	1	1	1	1	1	1	1	1	1	1	1	1	1	1	1	1	1	1	1	1	1	1	1	1	1	1	1	1	1	1	1	1	1	1	1	1	1	1	1	1	1	1	1	1	1	1	1	1	1	1	1	1	1	1	1	1	1	1	1	1	1	1	1	1	1	1	1	1	1	1	1	1	1	1	1	1	1	1	1	1	1	1	1	1	1	1	1	1	1	1	1	1	1	1	1	1	1	1	1	1	1	1	1	1	1	1
1	1	1	1	1	1	1	1	1	1	1	1	1	1	1	1	1	1	1	1	1	1	1	1	1	1	1	1	1	1	1	1	1	1	1	1	1	1	1	1	1	1	1	1	1	1	1	1	1	1	1	1	1	1	1	1	1	1	1	1	1	1	1	1	1	1	1	1	1	1	1	1	1	1	1	1	1	1	1	1	1	1	1	1	1	1	1	1	1	1	1	1	1	1	1	1	1	1	1	1	1	1	1	1	1	1	1	1	1	1	1	1	1	1	1	1	1	1	1	1	1	1	1	1	1	1	1	1	1	1	1	1	1	1	1	1	1	1	1	1	1	1	1	1	1	1	1	1	1	1	1	1	1	1	1	1	1	1	1	1	1	1	1	1
1	1	1	1	1	1	1	1	1	1	1	1	1	1	1	1	1	1	1	1	1	1	1	1	1	1	1	1	1	1	1	1	1	1	1	1	1	1	1	1	1	1	1	1	1	1	1	1	1	1	1	1	1	1	1	1	1	1	1	1	1	1	1	1	1	1	1	1	1	1	1	1	1	1	1	1	1	1	1	1	1	1	1	1	1	1	1	1	1	1	1	1	1	1	1	1	1	1	1	1	1	1	1	1	1	1	1	1	1	1	1	1	1	1	1	1	1	1	1	1	1	1	1	1	1	1	1	1	1	1	1	1	1	1	1	1	1	1	1	1	1	1	1	1	1	1	1	1	1	1	1	1	1	1	1	1	1	1	1	1	1	1	1	1
1	1	1	1	1	1	1	1	1	1	1	1	1	1	1	1	1	1	1	1	1	1	1	1	1	1	1	1	1	1	1	1	1	1	1	1	1	1	1	1	1	1	1	1	1	1	1	1	1	1	1	1	1	1	1	1	1	1	1	1	1	1	1	1	1	1	1	1	1	1	1	1	1	1	1	1	1	1	1	1	1	1	1	1	1	1	1	1	1	1	1	1	1	1	1	1	1	1	1	1	1	1	1	1	1	1	1	1	1	1	1	1	1	1	1	1	1	1	1	1	1	1	1	1	1	1	1	1	1	1	1	1	1	1	1	1	1	1	1	1	1	1	1	1	1	1	1	1	1	1	1	1	1	1	1	1	1	1	1	1	1	1	1	1
1	1	1	1	1	1	1	1	1	1	1	1	1	1	1	1	1	1	1	1	1	1	1	1	1	1	1	1	1	1	1	1	1	1	1	1	1	1	1	1	1	1	1	1	1	1	1	1	1	1	1	1	1	1	1	1	1	1	1	1	1	1	1	1	1	1	1	1	1	1	1	1	1	1	1	1	1	1	1	1	1	1	1	1	1	1	1	1	1	1	1	1	1	1	1	1	1	1	1	1	1	1	1	1	1	1	1	1	1	1	1	1	1	1	1	1	1	1	1	1	1	1	1	1	1	1	1	1	1	1	1	1	1	1	1	1	1	1	1	1	1	1	1	1	1	1	1	1	1	1	1	1	1	1	1	1	1	1	1	1	1	1	1	1

[MAP_INFOR]
195	432

[OBJECTS]
# type	x	y	ani_set_id	extra_settings per object type
# type: 0 = Mario , 1 = Brick, 2 = Goomba, 3 = Koopas,4 = Flower, 5 = Ground, 6 = ColorBox, 7 = Pipe, 8 = QuestionBrick, 9 = WeakBreak, 10 = CloundBrick, 11 = Coin, 12 = Bullet
# Ground
1	5	0	416	22	80	1	0	0	6	1	
2	5	1296	416	22	11	1	6	0	7	1	
3	5	1489	416	22	66	1	7	0	13	1	
# ColorBox
1	6	176	384	20	4	1	0	0	1	0	
2	6	224	336	20	4	1	1	0	1	0	
3	6	1552	368	20	5	1	7	0	8	0	
4	6	1568	272	20	4	1	8	0	8	0	
5	6	1648	336	20	4	1	8	0	8	0	
6	6	1728	304	20	4	1	8	0	9	0	
7	6	1760	352	20	5	1	9	0	9	0	
8	6	1856	320	20	4	1	9	0	9	0	
9	6	1936	288	20	4	1	9	0	10	0	
# Qbrick
1	8	608	336	21	1	1	4	3	0	3	0	
2	8	528	384	21	1	1	0	2	0	2	0	
3	8	640	368	21	1	1	0	3	0	3	0	
# weak Brick
1	9	592	336	22	1	1	0	3	0	3	0	
2	9	608	336	22	1	1	0	3	0	3	0	
3	9	624	336	22	1	1	0	3	0	3	0	
4	9	640	336	22	1	1	0	3	0	3	0	
5	9	512	352	22	1	1	0	2	0	2	0	
6	9	528	352	22	1	1	0	2	0	2	0	
7	9	544	352	22	1	1	0	2	0	2	0	
8	9	592	352	22	1	1	0	3	0	3	0	
9	9	608	352	22	1	1	0	3	0	3	0	
10	9	640	352	22	1	1	0	3	0	3	0	
11	9	512	368	22	1	1	0	2	0	2	0	
12	9	528	368	22	1	1	0	2	0	2	0	
13	9	560	368	22	1	1	0	2	0	2	0	
14	9	576	368	22	1	1	0	2	0	3	0	
15	9	512	384	22	1	1	0	2	0	2	0	
16	9	576	384	22	1	1	0	2	0	3	0	
17	9	592	384	22	1	1	0	3	0	3	0	
18	9	608	384	22	1	1	0	3	0	3	0	
19	9	624	384	22	1	1	0	3	0	3	0	
20	9	640	384	22	1	1	0	3	0	3	0	
21	9	512	400	22	1	1	0	2	0	2	0	
22	9	528	400	22	1	1	0	2	0	2	0	
23	9	544	400	22	1	1	0	2	0	2	0	
24	9	608	400	22	1	1	0	3	0	3	0	
25	9	624	400	22	1	1	0	3	0	3	0	
26	9	640	400	22	1	1	0	3	0	3	0	
#go~
1	9	720	352	22	1	1	0	3	0	3	0	
2	18	720	352	27	1	1	0	3	0	3	0	
3	18	736	352	27	1	1	0	3	0	3	0	
4	18	752	352	27	1	1	0	3	0	3	0	
5	18	768	352	27	1	1	0	3	0	4	0	
#						
1	18	832	352	27	1	1	0	4	0	4	0	
2	18	832	368	27	1	1	0	4	0	4	0	
3	18	832	384	27	1	1	0	4	0	4	0	
4	18	832	400	27	1	1	0	4	0	4	0	
#						
1	18	960	368	27	1	1	1	4	0	5	0	
2	18	960	384	27	1	1	0	4	0	5	0	
3	18	960	400	27	1	1	0	4	0	5	0	
#						
1	18	1088	352	27	1	1	0	5	0	5	0	
2	18	1088	368	27	1	1	0	5	0	5	0	
3	18	1088	384	27	1	1	0	5	0	5	0	
4	18	1088	400	27	1	1	0	5	0	5	0	
#						
1	18	1216	352	27	1	1	0	6	0	6	0	
2	18	1216	368	27	1	1	0	6	0	6	0	
3	18	1216	384	27	1	1	0	6	0	6	0	
4	18	1216	400	27	1	1	0	6	0	6	0	
#music note
1	19	480	368	28	1	1	1	2	0	2	0	
2	19	512	336	28	1	1	1	2	0	2	0	
3	19	544	368	28	1	1	2	2	0	2	0	
#coin
1	11	1008	336	5	1	1	12	5	0	5	0	
2	11	1024	336	5	1	1	12	5	0	5	0	
3	11	1040	336	5	1	1	12	5	0	5	0	
4	11	1136	336	5	1	1	12	5	0	5	0	
5	11	1152	336	5	1	1	12	5	0	5	0	
6	11	1168	336	5	1	1	12	5	0	6	0	
7	11	1584	336	5	1	1	12	8	0	8	0	
8	11	1664	304	5	1	1	12	8	0	8	0	
9	11	1716	272	5	1	1	12	8	0	8	0	
10	11	1748	272	5	1	1	12	8	0	9	0	
11	11	1764	272	5	1	1	12	9	0	9	0	
#boomerang brother
1	20	373	360	29	0	30	1	0	1	1	
2	20	1383	360	29	0	30	7	0	7	1	
#16	373	360	25	1	1.375
#goomba
1	2	929	360	3	1.25	1.5	0	0	4	0	4	0	
2	2	1058	360	3	1.25	1.5	1	1	5	0	5	0	
3	2	1186	360	3	1.25	1.5	1	1	6	0	6	0	
4	2	1644	387	3	1.25	1.5	0	0	8	0	8	0	
5	2	1684	387	3	1.25	1.5	0	0	8	0	8	0	
#koopas
1	3	250	387	4	1	1.625	1	1	1	0	1	0	
2	3	625	268	4	1	1.625	0	1	3	0	3	0	
3	3	1663	272	4	1	1.625	0	1	8	0	8	0	
4	3	771	387	4	1	1.625	1	1	3	0	4	0	
5	3	1900	387	4	1	1.625	1	1	9	0	9	0	
#endscene
1	14	2432	336	5	1	1	12	0	12	0	
